###############
A   #         #
# ### ####### #
#   # #   # # #
### # # # # # #
#   #   # #   #
# ####### #####
#   #     #   #
### # ### # # #
#   #   #   # #
# ####### ### #
# #     # # # #
# ### # # # # #
#     #   #   B
###############